1111111111111111111111111111111111111111111111
10C0000000000P000M0001111111111111111111111111
1000C0C000000000000001111111111111111111111111
1000111111111111111E00011111111111111111111111
1000C000M00000MM000000011111111111111111111111
1111111111111111111111111111111111111111111111
