111111111111111111111111
1100000000001P1111111111
1100C0C00000000001111111
11001111111111111111E111
110000000000000000000001
111111111111111111111111
