1111111111111111111111111111
1TC0000000000P00000001111111
1000000000000000000000111111
10001111111E1111111000011111
1000C000M00000M0000000001111
1000000000000000000000000111
1000000000000000000000C00011
100000000000000M0000000000T1
1000000000000000000000000001
100M000C00000000000000000001
1T00000000000000000000C000T1
1111111111111111111111111111
