1111111111111111111111111111
1T100C000001000C000000111111
1110000000P10000000000011111
10001111111E1111111000001111
1000C000M0001T10000000000111
1000000000011110000M00000011
1000000000010000000000000001
10000000M11100C0000000000001
1000000001T10000000000000001
100M000C01110000000000000001
1000000000000000000000000001
1111111111111111111111111111
