111111111111111111111111
1100000000001P1111111111
1100C0C00000000001111111
1100111111111111111E1111
11000000M00000M000000001
111111111111111111111111
