1111111111111111111111111111
1T100000000000000000000001T1
1110000110000M00111111100111
10000011C00000000000M1100001
10000100000000000000C1100001
100011C00000P000111111100001
1M00111111000000110000000001
100000001100EC0011C000000M01
1000000011001100111111100001
1110000000000000000000000111
1T100000000000000000000001T1
1111111111111111111111111111
