1111111111111111111
100P00000E000000MM1
1CCCC00000000001MM1
1CCCC00000000001111
1000000000000000001
1000000000000000001
1111111111111111111
