1111111111111111111
1P10000000000001MM1
1110000000000001MM1
1E00000000000001111
1110000000000000001
1C00000000000000001
1111111111111111111
