1111111111111111111
1E11000P00000011MM1
1CCC000000000000MM1
1111111111111111111
