100PCE0000000001MM1
100000000000001MMM1
1111111111111111111
