1111111111111111111
1P0000000E000001MM1
1000000000000001MM1
1000000000000001111
1000000000000000001
1000000000000000P01
1111111111111111111
