1111111111111111111
1P00000000000000MM1
1000000000000000MM1
1000000000000000001
1000000000000000001
10C0000000000000001
1111111111111111111
