1111111111111111111
100000000E000001MM1
1000000000000001MM1
1000000000000001111
1000000000000000001
1C00000000000000001
1111111111111111111
