1111111111111111111
1P10000000000001MM1
1110000000000001MM1
1000000000000001111
1110000000000000001
1C100000000000000E1
1111111111111111111
