1111111111111111111
100PCE0000000001MM1
1000000000000001MM1
1000000000000001MM1
1000000000000000001
1000000000000000001
1111111111111111111
