1111111111111111111
100PCE0000000001MM1
1000000000000001M01
1000000000000001MM1
1000000000000MMMMM1
10000000000000MMMM1
1111111111111111111
